WE ./game_textures/WE.xpm

C 255, 192, 203
F 0, 100, 100

SO ./game_textures/SO.xpm
NO ./game_textures/NO.xpm

EA ./game_textures/EA.xpm

1111111111111111111111111
1000000000110000000000001
1011000001110000000000001
1001000000000				000000000001
111111111011000001110000000000001
100000000011000001110111111111111
11110111111111011100000010001
11110111111111011101010010001
110000001101011100000010001
10000000000000001100000010001
10000000000000001101   	010010001
11000001110101011111011110N0111
11110111 1110101 101111010001
11111111 1111111 111111111111