C 0,0,255
F 0, 100, 100








WE ./game_textures/WE.xpm
SO ./game_textures/SO.xpm
NO ./game_textures/NO.xpm





EA ./game_textures/EA.xpm

1111
10N1
1111



