WE ./game_textures/WE.xpm
SO ./game_textures/SO.xpm
NO ./game_textures/NO.xpm

C 0,0,1
F 1,0,14









EA ./game_textures/EA.xpm


1111111111111111111
1111111101111111111
11111111N1111111111
1111111101111111111
1111111111111111111
