WE ./game_textures/WE.xpm
SO ./game_textures/SO.xpm
NO ./game_textures/NO.xpm

C 0,0,0
F 1,0,1









EA ./game_textures/EA.xpm

1111111111
                    N1


