C 0,0,255
F 0, 100, 100








WE ./game_textures/WE.xpm
SO ./game_textures/SO.xpm
NO ./game_textures/NO.xpm





EA ./game_textures/EA.xpm


11111111111111111111
10000000000000000001111
1000000000S000000001111111111111111
1000000000000000000111
11111111111111111111
