WE ./game_textures/WE.xpm
C 250, 160, 160
F 234, 221, 202
SO ./game_textures/SO.xpm


NO ./game_textures/NO.xpm


EA ./game_textures/EA.xpm

        1111111111111111111111111
        1000000000110000000000001
        101100000111000000S0000001
        1001000000000000000000001
111111111011000001110000000000001
10000000001100001110111111111111
11110111111111011100000010001
1111011111111101110101010001
11000000110101011100000010001
10000000000000001100000010001
10000000000000001101010010001
110000011101010111110111100111
11110111 1110101 101111010001
11111111 1111111 111111111111
        1111111111111111111111111
        1000000000110000000000001
        10110000011100000000000001
        1001000000000000000000001
111111111011000001110000000000001
10000000001100001110111111111111
11110111111111011100000010001
1111011111111101110101010001
11000000110101011100000010001
10000000000000001100000010001
10000000000000001101010010001
110000011101010111110111100111
11110111 1110101 101111010001
11111111 1111111 111111111111
