WE ./game_textures/WE.xpm
SO ./game_textures/SO.xpm
NO ./game_textures/NO.xpm

C 0,0,1
F 1,0,14









EA ./game_textures/EA.xpm


1111111
1000101
1011111
1111111
11111N1
