WE ./game_textures/WE.xpm
C 250, 160, 160
F 234, 221, 202
SO ./game_textures/SO.xpm


NO ./game_textures/NO.xpm


EA ./game_textures/EA.xpm

    1
   101
  10001
 11000011
 11000011
  11011
   111
    1    1
   101
  10001
 11000011
 11000011
  11011
   111
    1    1
   101
  10001
 110N0011
 11000011
  11011
   111
    1    1
   101
  10001
 11000011
 11000011
  11011
   111
    1    1
   101
  10001
 11000011
 11000011
  11011
   111
    0    1
   101
  10001
 11000011
 11000011
  11011
   111
    1
