WE ./game_textures/WE.xpm
C 255, 192, 203
F 0, 100, 100
SO ./game_textures/SO.xpm


NO ./game_textures/NO.xpm

EA ./game_textures/EA.xpm

1 
111111111111
0001
00011
11101
1
10000000001
11110111111
110S11111
00000110
000000
00000000
1000001110
1110111 11
111111 11
