WE ./game_textures/WE.xpm
C 250, 160, 160
F 234, 221, 202
SO ./game_textures/SO.xpm


NO ./game_textures/NO.xpm


EA ./game_textures/EA.xpm

11111111111111111111
10000000000000001001
10000000000100001001
10000000000N00000001
10000110000100000101
10000110000100000101
10000110000100000101
10000110000100000101
10000110000100000101
10000110000100000101
10000110000100000101
11111111111111111111

