WE ./game_textures/WE.xpm
SO ./game_textures/SO.xpm
NO ./game_textures/NO.xpm
EA ./game_textures/EA.xpm

F 40, 40, 40
C 70, 70, 70

111111111111111111111111111111111111111111111111
100000000000000000000000000000000000000000000001
100000000000000110000000000000011000000010000001
100000000000000110000000000000011000000010000001
100000000000000000100000000000011000000000000001
111111111111111000111111111111111111111101111111
111111111111111000111111111111111111111101111111
100000000000000000000000000000011000000000000001
100000000000000110000000000000000000000000000001
100000000000000110000000000000011000000000000001
100000000000000110000000000000011000000000000001
101111111111111111111110011111111111111001111111
111111111111111111111100111111111111110011111111
100000000000000110000000000000011000000000000001
100000000000000110000000000000000000000000000001
1000001000000001100000000000000110000000N0000001
100000100000000110000000000000011000000000000001
111111111111111111111111111111111111111111111111

