C 5,5,45
WE ./game_textures/WE.xpm
SO ./game_textures/SO.xpm
NO ./game_textures/NO.xpm
EA ./game_textures/EA.xpm
F 30,5,5

               1
              1E1
             11011
            1000001
           100000001
     111111000000000111111
     100000001000000000001
     100001001000101000001
     100010101000100000001
     100011001000101110001
      101 10000000001 101
     100011000101000110001
 1111000000000101000000000111111
100000000000001010101000000000001
 1111000000000101000000000111111
     100000000000000000001
      1000000010100000001
       10000001010000001
        100000101000001
         1000010100001
          10001010001
          10001010001
          10001010001
           100000001
            1000001
             10001
              101
               1