C 255, 192, 203
F 0, 100, 100

WE ./game_textures/WE.xpm
SO ./game_textures/SO.xpm
NO ./game_textures/NO.xpm
EA ./game_textures/EA.xpm

      1111111111
      1000000001
      1001111111
      1001
      1001111111
      1000000001
      1N01111111
      1001
11111110011
10000000001
11111111111
