NO ./game_textures/NO.xpm
SO ./game_textures/SO.xpm
EA ./game_textures/EA.xpm
WE ./game_textures/WE.xpm

C 0,0,139
F 90,90,90

1111111111111111111111111
			10000000001100000000W0001
1011000001110000000000001
1001000000000000000000001
111111111011000001110000000000001
100000000011000001110111111111111
1111011111111101110000010001
11110111111111011101010010001
11000000110101011100000010001
10000000000000001100000010001
10000000000000001101010010001
110000011101010111110111100111
11110111 1110101 101111010001
11111111 1111111 111111111111
