WE ./game_textures/WE.xpm
C 255, 192, 203
F 0, 100, 100
SO ./game_textures/SO.xpm


NO ./game_textures/NO.xpm

EA ./game_textures/EA.xpm

        1111111111111111111111111
        1000000000110000000000001
        1011000001110000000111001
        10010000000000000010N0101
111111111011000001110000000111001
100000000011000001110111111111111
11110111110011100000000010001
1111011111001 100010100100001
11000000110011100000000000001
10000000000000000000000010001

10000000000000001101010010101
1100000111010101111101111000111
11110111 1110101 101111010001
11111111 1111111 111111111111
